***************
***************
***##########**
***#****#***#**
***#****#*B*#**
***#*#**#*#P#**
***#*#*##**##**
**##*#******#**
**#**#*####*#**
**#*********#**
**#########*#**
**********#W#**
**********###**
***************
***************
